*********@-@*******************
**-*******---------************
**-*******-*******-************
**---------*******-************
**********-*******-************
**********-**------************
**********-**-****-----********
**********------***************
**********-****-***************
**********-****-----***********
**********-********-***********
**********-********-----*******
*@********-************-*******
*--*******-************------**
*@--******-*****************-**
***-******-*****************-**
***---****-***************-----
*****-****-***************-****
*****------***************-****
**********-----------------****
*******************************